11111111111111111111
18900000010000000001
17000000010000000001
16000000000000000001
12314510000000000001
11111111111111111111