1111111111111111111111111111111111
1000000000000000000000000000333001
1000000000000001110000000000111101
1000701010000111011000060001100101
1000155550011100001150000100000191
1111111111110000000111155111111111