1111111111111111111111111111111111
1000000000000000000000000000000001
1000000000000000000000000000000001
1000701010000000000000000000000001
1000155550010000000000000000000091
1111111111111111111111111111111111