1111111111111111111111111111111111
1000000000000000000000000000000001
1000000000000000000100000000000001
1000000000000000000100000000000001
1000000000000000000155500000000001
1111111111111111111111111111111111